X_XXXXXXXX
X_XX____XX
X_X__XX_XX
X_XXXXX_XX
X_X___X_XX
X_X_X___XX
X_X_X_XXXX
X___X_XXXX
XXXXX____X
XXXXXXXX_X